16
2102102210122012
1              1
2              2
0  1  2  1  2  1
1  1  1  2  2  1
2  1  2  2  1  2
1  2  1  0  1  2
1              1
1              2
2  0  2111  1  2
2  1  1111     1
2  1  1111     1
1  1  1110  1  2
2              2
2              2
2222122122211222
